1111111111111111112111111111111111111
1222222222222222222222222222222222221
1212111211121112121212111211121112121
1212221222221222121212221222221222121
1212121112111212121212121112111212121
1212121222221212121212121222221212121
1222121211121212221222121211121212221
1212121222221212121212121222221212121
1212121122211212121212121122211212121
1211122224222211122211122224222211121
1212121122211212121212121122211212121
1212121222221212121212121222221212121
1222121211121212221222121211121212221
1212121222221212121212121222221212121
1212121112111212121212121112111212121
1212221222221222121212221222221222121
1212111211121112121212111211121112121
1222222222222122222222212222222222221
2212111122211111123211111122211112122
1222222222222222222222222222222222221
1212111211121112121212111211121112121
1212221222221222121212221222221222121
1212121112111212121212121112111212121
1212121222221212121212121222221212121
1222121211121212221222121211121212221
1212121222221212121212121222221212121
1212121122211212121212121122211212121
1211122224222211122211122224222211121
1212121122211212121212121122211212121
1212121222221212121212121222221212121
1222121211121212221222121211121212221
1212121222221212121212121222221212121
1212121112111212121212121112111212121
1212221222221222121212221222221222121
1212111211121112121212111211121112121
1222222222222222222222222222222222221
1111111111111111112111111111111111111