1111111111111111111111111111111111111111111111111
1222222222222222222222222222222222222222222222221
1211212121121211212121121211212121121211212121121
1212212122121212212122121212212122121212212122121
1222112112221222112112221222112112221222112112221
1212222222121212222222122212222222121212222222121
1212112112122212112112121212112112122212112112121
1212222222121212222222121212222222121212222222121
1222112112221222112112221222112112221222112112221
1212212122121212212122122212212122121212212122121
1211212121121211212121121211212121121211212121121
1222222222222222222222221222222222222222222222221
1211112111124211112111121211112111124211112111121
1222222222222222222222222222222222222222222222221
1211212121121211212121121211212121121211212121121
1212212122121212212122121212212122121212212122121
1222112112221222112112221222112112221222112112221
1212222222121212222222122212222222121212222222121
1212112112122212112112121212112112122212112112121
1212222222121212222222121212222222121212222222121
1222112112221222112112221222112112221222112112221
1212212122121212212122122212212122121212212122121
1211212121121211212121121211212121121211212121121
1222222222222222222222222222222222222222222222221
1211121112111211121112223222111211121112111211121
1222222222222222222222222222222222222222222222221
1211212121121211212121121211212121121211212121121
1212212122121212212122122212212122121212212122121
1222112112221222112112221222112112221222112112221
1212222222121212222222121212222222121212222222121
1212112112122212112112121212112112122212112112121
1212222222121212222222122212222222121212222222121
1222112112221222112112221222112112221222112112221
1212212122121212212122121212212122121212212122121
1211212121121211212121121211212121121211212121121
1222222222222222222222222222222222222222222222221
1211112111124211112111121211112111124211112111121
1222222222222222222222221222222222222222222222221
1211212121121211212121121211212121121211212121121
1212212122121212212122122212212122121212212122121
1222112112221222112112221222112112221222112112221
1212222222121212222222121212222222121212222222121
1212112112122212112112121212112112122212112112121
1212222222121212222222122212222222121212222222121
1222112112221222112112221222112112221222112112221
1212212122121212212122121212212122121212212122121
1211212121121211212121121211212121121211212121121
1222222222222222222222222222222222222222222222221
1111111111111111111111111111111111111111111111111