1111111111111111111111111111111111111111111111111
1000000000000000000000000000000000000000000000001
1011010101101011010101101011010101101011010101101
1010010100101010010100101010010100101010010100101
1000110110001000110110001000110110001000110110001
1010000000101010000000100010000000101010000000101
1010110110100010110110101010110110100010110110101
1010000000101010000000101010000000101010000000101
1000110110001000110110001000110110001000110110001
1010010100101010010100100010010100101010010100101
1011010101101011010101101011010101101011010101101
1000000000000000000000001000000000000000000000001
1011110111104011110111101011110111104011110111101
1000000000000000000000000000000000000000000000001
1011010101101011010101101011010101101011010101101
1010010100101010010100101010010100101010010100101
1000110110001000110110001000110110001000110110001
1010000000101010000000100010000000101010000000101
1010110110100010110110101010110110100010110110101
1010000000101010000000101010000000101010000000101
1000110110001000110110001000110110001000110110001
1010010100101010010100100010010100101010010100101
1011010101101011010101101011010101101011010101101
1000000000000000000000000000000000000000000000001
1011101110111011101110003000111011101110111011101
1000000000000000000000000000000000000000000000001
1011010101101011010101101011010101101011010101101
1010010100101010010100100010010100101010010100101
1000110110001000110110001000110110001000110110001
1010000000101010000000101010000000101010000000101
1010110110100010110110101010110110100010110110101
1010000000101010000000100010000000101010000000101
1000110110001000110110001000110110001000110110001
1010010100101010010100101010010100101010010100101
1011010101101011010101101011010101101011010101101
1000000000000000000000000000000000000000000000001
1011110111104011110111101011110111104011110111101
1000000000000000000000001000000000000000000000001
1011010101101011010101101011010101101011010101101
1010010100101010010100100010010100101010010100101
1000110110001000110110001000110110001000110110001
1010000000101010000000101010000000101010000000101
1010110110100010110110101010110110100010110110101
1010000000101010000000100010000000101010000000101
1000110110001000110110001000110110001000110110001
1010010100101010010100101010010100101010010100101
1011010101101011010101101011010101101011010101101
1000000000000000000000000000000000000000000000001
1111111111111111111111111111111111111111111111111